SSSUUUUUUUOUUUUUOUUU
SSSUUUUUUUOUUUUUOUUU
SSSUUUUUUUOUUUUUOUUU
UUUUUUUUUUOOUUUUOUUU
UUUUOOUUUUUUUUUUUUUU
UUUUUOUUUUUUUUUUUUUU
UUUUUOUUUUUUUUUUUUUU
UUUUUOUUUUUUUUOOUUUO
UUUUUOUUUUUUUUOUUUUU
UUUUUOUUUUUUOOOUUUUU
UUUUUUUUUUUUUUUUUUUU
UUUUUUUUUUUUUUUUUUUU
UUUUUUUUUUUUUUUUUEEE
UUUUOUUUUUUUUUUUUEEE
UUUUOOOOUUUUUOOUUEEE