SSSUUUUUUUOUUUUUOUUU
SSSUUUUUUUOUUUUUOUUU
SSSUUUUUUUOUUUUUOUUU
UUUUUUUUUUOOUUUOOUUU
UUUUUOUUUUUUUUUUUUUU
UUUUUOUUUUUUUUUUUUUU
UUUUUOUUUUUUUUUUUUUU
OUUUUOUUUUUUUUUOUUUO
OUUUUOUUUUUUUUOUUUUO
OUUUUOUUUUUUUOUUUUUU
UUUUUUUUUUOOOUUUUUUU
UUUUUUUUUUUUUUUUUUUU
UUUUUUUUUUUUUUUUUEEE
UUUUUUUUUUUUUUUUUEEE
UUUUUOOOUUUUUUUUUEEE