SSSUUUUUUUOOOUUUOUUU
SSSUUUUUUUUUUUUUOUUU
SSSUUUUUUUUUUUUUOUUU
UUUUUUOUUUUUUUUOOUUU
UUUUUOUUUUUUUUUUUUUU
UUUUOUUUUUUUUUUUUUUU
UUUOUUUUUUUUUUUUUUUU
UUUUUUUUUUOOOOOOUUUO
UUUUUUUUUUOUUUUUUUUU
UUUUUUOUUUUUUUUUUUUU
UUUUUUOUUUUUUUUUUUUU
UUUUUUOUUUUUUUUUUUUU
UUUUUUOUUUUOUUUUUEEE
UUUUUUOUUUUOUUUUUEEE
UUUUUUOUUUUOOUUUUEEE