SSSUUUUUOOOUUUUUOUUU
SSSUUUUUUUUUUUUUOUUU
SSSUUUUUUUUUUUUUOUUU
UUUUUUUUUUUUUUUOOUUU
UUUUOUUUUUUUUUUUUUUU
UUUOUUUUUUUUUUUUUUUU
UUOUUUUUUUUUUUUUUUUU
UOUUUUUUUUOOOOOOUUUO
UUUUUUUUUUUUUUUOUUUU
UUUUUUOUUUUUUUUOUUUU
UUUUUUOUUUUUUUUUUUUU
UUUUUUOUUUUUUUUUUUUU
UUUUUUOUUUUOUUUUUEEE
UUUUUUOUUUUOUUUUUEEE
UUUUUUOUUUUOUUUUUEEE