SSSUUUOUUUUUUUUUUUUU
SSSUUUOUUUUUUUUUUUUU
SSSUUUOUUUUUUUUUUUUU
UUUUUUOUUUUUOUUUUUUU
UUUUUUOUUUUUUUUUUUUU
UUUUUUOUUUUUUUUUUOOO
UUUUUUUUUUUUUUUUUUUU
UUUUUUUUUUUUUUUUUUUU
UUUUUUUUUUUOUUUUUUUU
OOOUUUUUUUOUUUUUUUUU
UUUUUUUUUUUUUUUUUUUU
UUUUUUOUUUUUUUUUUUUU
UUUUUUUUUUUUUUOUUEEE
UUUUUUUUUUUUUUOUUEEE
UUUUUUUUUUUUUUOUUEEE